12222222222222222222222222222223
89999999999999999999999999999994
89999999999999999999999999999994
89999999999999999999999999999994
89999999999999999999999999999994
89999999999999999999999999999994
89999999999999999999999999999994
89999999999999999999999999999994
89999999999999999999999999999994
89999999999999999999999999999994
89999999999999999999999999999994
89999999999999999999999999999994
76666666666666666666666666666665