000000000000000000000000000000000000000000000000000000000000000000000000000000000000000000000000000000
000000000000000000000000000000000000000000000000000000000000000000000000000000000000000000000000000000
000000000000000000000000000000000000000000000000000000000000000000000000000000000000000000000000000000
000000000000000000000000000000000000000000000000000000000000000000000000000000000000000000000000000000
000000000000000000000000000000000000000000000000000000000000000000000000000000000000000000000000000000
000000000000000000000000000000000000000000000000000000000000000000000000000000000000000000000000000000
00000000000000000000000w0000000000000w000000000000000w000000000000000000000000000000000000000000000000
000000000000000000000000000000000000000000000000000000000000000000000000000000000000000000000000000000
0000000000000000000000000000w0000001222222222222222222222222222222300000000000000000000000000000000000
000000000000000000000000000000000008999999999999999999999999999999400000000000000000000000000000000000
000000000000000000000000000000000008999999999999999999999999999999400000000000000000000000000000000000
0000000000000000000000000000000000089999999999999999999999999999994000000000w0000000000000000000000000
0000000000000000000000000000000w00089999999999999999999999999999994000000000w0000000000000000000000000
00000000000000000000000000000w000008999999999999999999999999999999400000000000000000000000000000000000
00000000000000000000000w000000000008999999999999999999999999999999400000w00000000000000000000000000000
000000000000000000000000000000000008999999999999999999999999999999400000000000000000000000000000000000
000000000000000000000000000w00000008999999999999999999999999999999400w00000000000000000000000000000000
000000000000000000000000000000000008999999999999999999999999999999400000000000000000000000000000000000
0000000000000000000000000000000w0008999999999999999999999999999999400000000000000000000000000000000000
0000000000000000000000000000000000089999999999999999999999999999994000000000000000w0000000000000000000
000000000000000000000000000000000007666666666666666666666666666666500000000000000000000000000000000000
0000000000000000000000000000000000000000w00ww000000000000000000000000000000000000000000000000000000000
00000000000000000000000000000000000000w000000000000000000000000000000000000000000000000000000000000000
0000000000000000000000000000000000000000000000000000w0000000000000000000000000000000000000000000000000
000000000000000000000000000000000000000000000000000000000000000000000000000000000000000000000000000000
00000000000000000000000000000000000000000000000000000000000000000000000w000000000000000000000000000000
00000000000000000000000000000000000w000000000000000000000000000000000000000000000000000000000000000000
000000000000000000000000000000000000000000000000000000000000000000000000000000000000000000000000000000
000000000000000000000000000000000000000000000000000000000000000000000000000000000000000000000000000000