000000000000000000000000000000000000000000000000000000000000000000000000000000000000000000000000000000
000000000000000000000000000000000000000000000000000000000000000000000000000000000000000000000000000000
000000000000000000000000000000000000000000000000000000000000000000000000000000000000000000000000000000
000000000000000000000000000000000000000000000000000000000000000000000000000000000000000000000000000000
000000000000000000000000000000000000000000000000000000000000000000000000000000000000000000000000000000
000000000000000000000000000000000000000000000000000000000000000000000000000000000000000000000000000000
000000000000000000000000000000000000000000000000000000000000000000000000000000000000000000000000000000
000000000000000000000000000000000000000000000000000000000000000000000000000000000000000000000000000000
000000000000000000000000000000000001222222222222222222222222222222300000000000000000000000000000000000
000000000000000000000000000000000008999999999999999999999999999999400000000000000000000000000000000000
000000000000000000000000000000000008999999999999999999999999999999400000000000000000000000000000000000
000000000000000000000000000000000008999999999999999999999999999999400000000000000000000000000000000000
000000000000000000000000000000000008999999999999999999999999999999400000000000000000000000000000000000
000000000000000000000000000000000008999999999999999999999999999999400000000000000000000000000000000000
000000000000000000000000000000000008999999999999999999999999999999400000000000000000000000000000000000
000000000000000000000000000000000008999999999999999999999999999999400000000000000000000000000000000000
000000000000000000000000000000000008999999999999999999999999999999400000000000000000000000000000000000
000000000000000000000000000000000008999999999999999999999999999999400000000000000000000000000000000000
000000000000000000000000000000000008999999999999999999999999999999400000000000000000000000000000000000
000000000000000000000000000000000008999999999999999999999999999999400000000000000000000000000000000000
000000000000000000000000000000000007666666666666666666666666666666500000000000000000000000000000000000
000000000000000000000000000000000000000000000000000000000000000000000000000000000000000000000000000000
000000000000000000000000000000000000000000000000000000000000000000000000000000000000000000000000000000
000000000000000000000000000000000000000000000000000000000000000000000000000000000000000000000000000000
000000000000000000000000000000000000000000000000000000000000000000000000000000000000000000000000000000
000000000000000000000000000000000000000000000000000000000000000000000000000000000000000000000000000000
000000000000000000000000000000000000000000000000000000000000000000000000000000000000000000000000000000
000000000000000000000000000000000000000000000000000000000000000000000000000000000000000000000000000000
000000000000000000000000000000000000000000000000000000000000000000000000000000000000000000000000000000